44,29
            1111111111111111111111111111111 
            1000000000000000000000000000001 
            1000000000000000000000000000001 
            1000111111111111111111111111001 
            10001                      1001 
            10001                      1001 
            10001                      1001 
            10001                      1001 
            10001      11111111111111111001 
            10001      10000000000000000001 
            10001      10000000000000000001 
111111      1000111111110000000000000000001 
10000111111110000000000000000000000000000011
10000000000000000000000000000000001110000001
10000000000000000000000000000000001 10000001
10000111111110000000000000000000001110000011
111111      1000111111110000000000000000001 
            10001      10000000000000000001 
            10001      10000000000000000001 
            10001      11100111111111111001 
            10001        1001          1001 
            10001       110011         1001 
            10001       100001         1001 
            10001       111111         1001 
            10001                      1001 
            1000111111111111111111111111001 
            1000000000000000000000000000001 
            1000000000000000000000000000001 
            1111111111111111111111111111111 
 