42,30
11111
100011111111111111   
100000000000000001   
100011110000000001   
11111  10000000001   
       10000000001   
       10000000001   
       10000000001   
111111110000000001   
100000000000000001   
100011000000110001   111111111111111111111
100011000000110001   100000000000000000001
100000000000000001   100000000000000000001
100000001100000001   100000110000011000001
100000001100000001   100000110000011000001
100011000000110001   100000000000000000001
100011000000110001   100000000000000000001
100000000000000001   100000110000011000001
100011111111111111   100000110000011000001
10001                100000000000000000001
100011111111111111111100000000000000000001
100000000000000000000000000000000000000001
100000000000000000000000000000000000000001
100000011000011000011000001100000110000001
100000011000011000011000001100000110000001
100000000000000000000000000000000000000001
100000000000000000000000000000000000000001
111111111111111111111111111111111111110011
                                     1001 
                                     1111 