59,29
            111111111111111111111111111111111111111111111
            100000000000000000000000000000000000000000001
            100000000000000000000000000000000000000000001
            100011111111111111111111111111111111111111001
            10001                                    1001
            10001                                    1001
            10001                                    1001
            10001                                    1001
            10001      1111111111111111111111111111111001
            10001      1000000000000000000000000000000001
            10001      1000000000000000000000000000000001
111111      100011111111000000000000000000000000000000001
1000011111111000000000000000000000000000000000000000000011
1000000000000000000000000000000000000111000000000000000001
10000000000000000000000000000000000001 1000000000000000001
1000011111111000000000000000000000000111000000000000000011
111111      100011111111000000000000000000000000000000001
            10001      1000000000000000000000000000000001
            10001      1000000000000000000000000000000001
            10001      1110011111111111111111111111111001
            10001        1001                        1001
            10001       110011                       1001
            10001       100001                       1001
            10001       111111                       1001
			10001                                    1001
            100011111111111111111111111111111111111111001
            100000000000000000000000000000000000000000001
            100000000000000000000000000000000000000000001
            111111111111111111111111111111111111111111111
 