130,80
111111111111111111111111111111111111111111111111111111111              1111111111111111111111111111111111111                      
111111111111111111111111111111111111111111111111111111111              1111111111111111111111111111111111111                      
111000000000000000000000000000000000000000000000000000111              1100000000000000000000000000000000111                      
111000000000000000000000000000000000000000000000000000111              1100000000000000000000000000000000111                      
111000000000000000000000000000000000000000000000000000111              1100000000000000000000000000000000111                      
111000000000000000000000000000000000000000000000000000111              1100000000000000000000000000000000111                      
111000000000000000000000000000000000000000000000000000111              1100000000000000000000000000000000111                      
111000000000000000000000000000000000000000000000000000111              1100000000000000000000000000000000111                      
111000000000000000000000000000000000000000000000000000111              1100000000000000000000000000000000111                      
111000000000000000000000000000000000000000000000000000111              1100000000000000000000000000000000111                      
111000000000000000000000000000000000000000000000000000111              1100000000000000000000000000000000111                      
111000000000000000000000000000000000000000000000000000111              1100000000000000000000000000000000111                      
111000000000000000000000000000000000000000000000000000111              1100000000000000000000000000000000111                      
111000000000000000000000000000000000000000000000000000111              1100000000000000000000000000000000111                      
111000000000000000000000000000000000000000000000000000111              1100000000000000000000000000000000111                      
111000000000000000000000000000000000000000000000000000111              1100000000000000000000000000000000111                      
111000000000000000000000000000000000000000000000000000111              1100000000000000000000000000000000111                      
111000000000000000000000000000000000000000000000000000111              1100000000000000000000000000000000111                      
111000000000000000000000000000000000000000000000000000111              1100000000000000000000000000000000111                      
111000000000000000000000000000000000000000000000000000111              1100000000000000000000000000000000111                      
111111111111111111111111111111111111111111111000000000111              1100000000000000000000000000000000111                      
111111111111111111111111111111111111111111111000000000111              1100000000000000000000000000000000111                      
                                          111000000000111              1100000000000000000000000000000000111                      
                                          111000000000111                              111100000001111111111                      
                                          111000000000111                              111100000001111111111                      
                                          111000000000111111111111111111111111111111111111100000001111111111                      
1111111111111111111111111111111111111111111110000000001111111111111111111111111111111111111000000011111111111111111111111111111111
1110000000000000000000000000000000000000000000000000000000000000000000000000000000000000000000000000000000000000000000000000001111
1110000000000000000000000000000000000000000000000000000000000000000000000000000000000000000000000000000000000000000000000000001111
1110000000000000000000000000000000000000000000000000000000000000000000000000000000000000000000000000000000000000000000000000001111
1110000000000000000000000000000000000000000000000000000000000000000000000000000000000000000000000000000000000000000000000000001111
1110000000000000000000000000000000000000000000000000000000000000000000000000000000000000000000000000000000000000000000000000001111
1110000000000000000000000000000000000000000000000000000000000000000000000000000000000000000000000000000000000000000000000000001111
1110000000000000000111111111111111111111111111111111111111111111111111111111111111111111111111111111111111111111111111111111111111
1110000000000000000111111111111111111111111111111111111111111111111111111111111111111111111111111111111111111111111111111111111111
1110000000000000000111111                                                                     110000000000000000000000000000001111
1110000000000000000111111                                                                     110000000000000000000000000000001111
1110000000000000000111111                                                                     110000000000000000000000000000001111
1110000000000000000111111                                                                     110000000000000000000000000000001111
1110000000000000000111111                                                                     110000000000000000000000000000001111
1110000000000000000111111                                                                     110000000000000000000000000000001111
1110000000000000000111111                                                                     110000000000000000000000000000001111
1110000000000000000111111                                                                     110000000000000000000000000000001111
1110000000000000000111111                                                                     110000000000000000000000000000001111
1110000000000000000111111                                                                     110000000000000000000000000000001111
1110000000000000000111111                                                                     110000000000000000000000000000001111
1110000000000000000111111                                                                     110000000000000000000000000000001111
1110000000000000000111111                                                                     110000000000000000000000000000001111
1110000000000000000111111111111111111111111111111111111111111111111111111111111111111111111111111111111111000000000000011111111111
1110000000000000000000000000000000000000000000000000000000000000000000000000000000000000000000000000000000000000000000000000001111
1110000000000000000000000000000000000000000000000000000000000000000000000000000000000000000000000000000000000000000000000000001111
1110000000000000000000000000000000000000000000000000000000000000000000000000000000000000000000000000000000000000000000000000001111
1110000000000000000000000000000000000000000000000000000000000000000000000000000000000000000000000000000000000000000000000000001111
1110000000000000000000000000000000000000000000000000000000000000000000000000000000000000000000000000000000000000000000000000001111
1110000000000000000000000000000000000000000000000000000000000000000000000000000000000000000000000000000000000000000000000000001111
1110000000000000000000000000000000000000000000000000000000000000000000000000000000000000000000000000000000000000000000000000001111
1110000000000000000000000000000000000000000000000000000000000000000000000000000000000000000000000000000000000000000000000000001111
1110000000000000000000000000000000000000000000000000000000000000000000000000000000000000000000000000000000000000000000000000001111
1110000000000000000000000000000000000000000000000000000000000000000000000000000000000000000000000000000000000000000000000000001111
1110000000000000000000000000000000000000000000000000000000000000000000000000000000000000000000000000000000000000000000000000001111
1111111111111111111111111111111111111111111111111111111111111111111111111100000000011111111111111111111111111111111111111111111111
1111111111111111111111111111111111111111111111111111111111111111111111111100000000011111111111111111111111111111111111111111111111
                                                                      111100000000000000000000000000000000000000000000000000000111
                                                                      111100000000000000000000000000000000000000000000000000000111
                                                                      111100000000000000000000000000000000000000000000000000000111
                                                                      111100000000000000000000000000000000000000000000000000000111
                                                                      111100000000000000000000000000000000000000000000000000000111
                                                                      111100000000000000000000000000000000000000000000000000000111
                                                                      111100000000000000000000000000000000000000000000000000000111
                                                                      111100000000000000000000000000000000000000000000000000000111
                                                                      111100000000000000000000000000000000000000000000000000000111
                                                                      111100000000000000000000000000000000000000000000000000000111
                                                                      111100000000000000000000000000000000000000000000000000000111
                                                                      111100000000000000000000000000000000000000000000000000000111
                                                                      111100000000000000000000000000000000000000000000000000000111
                                                                      111100000000000000000000000000000000000000000000000000000111
                                                                      111100000000000000000000000000000000000000000000000000000111
                                                                      111111111111111111111111111111111111111111111111111111111111
                                                                      111111111111111111111111111111111111111111111111111111111111
                                                                      111111111111111111111111111111111111111111111111111111111111



















