30,14
1111111111111111111
1000000000000000001
1000000000000000001
1000000000000000001
1111111110000000001
        10011111111
        1001
 11111111001         11111111
 1000000000111111111110000001
 1000000000000000000000000001
 1000000000000000011110000001
 111111110000000001  10000001
        10000000001  11111111
        11111111111          







