26,12
1111111111111111
1000000000000001
1000000000000001
1000000000000001
1000000000000001
1111111000110001
      10001100011111111111
11111110000000000000000001
10000000000000011110000001
1000000000000001  10000001
1000000000000001  10000001
1111111111111111  11111111









