89,35
            1111111111                                                                   
            1000000001                                                                   
            1000000001                                                                   
            1111001111                                                                   
111111111      1001                                                                      
100000001      1001                                                                  1111
1001100011111111001                                                                  1001
1001100000000000001                                                                  1001
1000000000000000001                                                                  1001
1001100011111111001                                                         1111111111001
100110001      1001             11111111111111111111111                     1000000000001
100000001      1001             10000000000000000000001                     1000000000001
111111111      1001             10000000000000000000001                     1000000111001
               1001             10000000000000000000001                     10000001 1001
               1001             10000000000000000000001                     11111111 1001
               1001             11001111111111111111111                              1001
               1001              1001                                                1001
               1001       11111111001111111111111                                    1001
               1001       10000000000000000000001                                    1001
               1001       10000000000000000000001                                    1001
               1001       10000000000000000000001                                    1001
               1001       10000000000000000000001                                    1001
               1001       11111111100111111111111                                    1001
               1001               1001                                               1001
               10011111111111111111001111111111111111111111111111111111111111111111111001
               10000000000000000000000000000000000000000000000000000000000000000000000001
               10000000000000000000000000000000000000000000000000000000000000000000000001
               11111111001111111111111111111111111111111100111111111111111111111111111111
                      1001                              1001                             
               11111111001111111111111         1111111111001111111111                    
               10000000000000000000001         1000000000000000000001                       
               10000000000000000000001         1000000000000000000001                    
               10000000000000000000001         1000000000000000000001                    
               10000000000000000000001         1000000000000000000001                     
               11111111111111111111111         1111111111111111111111                    