17,6
11111111111111111
11000000000000111
11000001100000111
11000001100000111
11000000000000111
11111111111111111